"aa" = (/turf/open/space/basic,/area/space)
"ab" = (/turf/closed/wall/mineral/sandstone,/area/ruin/space/has_grav/spacefort/wall)
"ac" = (/turf/open/floor/wood,/area/ruin/space/has_grav/spacefort/wall)
"ad" = (/obj/item/melee/chainofcommand/tailwhip,/turf/open/floor/wood,/area/ruin/space/has_grav/spacefort/wall)
"ae" = (/obj/item/stack/medical/gauze/improvised,/turf/open/floor/wood{icon_state = "wood-broken"},/area/ruin/space/has_grav/spacefort/wall)
"af" = (/turf/open/floor/wood{icon_state = "wood-broken"},/area/ruin/space/has_grav/spacefort/wall)
"ag" = (/obj/structure/closet/crate/coffin,/turf/open/floor/wood,/area/ruin/space/has_grav/spacefort/wall)
"ah" = (/obj/structure/table/wood,/obj/item/stack/sheet/animalhide/lizard,/turf/open/floor/wood,/area/ruin/space/has_grav/spacefort/wall)
"ai" = (/obj/structure/table/wood,/obj/item/stack/sheet/bone{amount = 20},/turf/open/floor/wood,/area/ruin/space/has_grav/spacefort/wall)
"aj" = (/obj/structure/table/wood,/obj/item/stack/sheet/bone{amount = 20},/turf/open/floor/wood{icon_state = "wood-broken"},/area/ruin/space/has_grav/spacefort/wall)
"ak" = (/obj/structure/table/wood,/obj/item/stack/sheet/cloth/ten,/turf/open/floor/wood{icon_state = "wood-broken"},/area/ruin/space/has_grav/spacefort/wall)
"al" = (/obj/structure/table/wood,/obj/item/stack/sheet/cloth/ten,/turf/open/floor/wood,/area/ruin/space/has_grav/spacefort/wall)
"am" = (/obj/structure/grille,/obj/structure/barricade/wooden/crude,/turf/open/floor/plasteel/rockvault/sandstone,/area/ruin/space/has_grav/spacefort/wall)
"an" = (/obj/structure/closet/crate/coffin,/turf/open/floor/wood{icon_state = "wood-broken"},/area/ruin/space/has_grav/spacefort/wall)
"ao" = (/mob/living/simple_animal/hostile/skeleton,/turf/open/floor/wood{icon_state = "wood-broken"},/area/ruin/space/has_grav/spacefort/wall)
"ap" = (/mob/living/simple_animal/hostile/skeleton,/turf/open/floor/wood,/area/ruin/space/has_grav/spacefort/wall)
"aq" = (/obj/item/stack/medical/gauze/improvised,/turf/open/floor/wood,/area/ruin/space/has_grav/spacefort/wall)
"ar" = (/obj/structure/table/wood,/obj/item/stack/sheet/iron/twenty,/turf/open/floor/wood{icon_state = "wood-broken"},/area/ruin/space/has_grav/spacefort/wall)
"as" = (/obj/structure/table/wood,/obj/item/stack/sheet/iron/twenty,/turf/open/floor/wood,/area/ruin/space/has_grav/spacefort/wall)
"at" = (/obj/structure/table/wood,/obj/item/stack/sheet/leather{amount = 20},/turf/open/floor/wood,/area/ruin/space/has_grav/spacefort/wall)
"au" = (/obj/structure/spawner/skeleton,/turf/open/floor/wood,/area/ruin/space/has_grav/spacefort/wall)
"av" = (/obj/structure/mineral_door/sandstone,/turf/open/floor/wood,/area/ruin/space/has_grav/spacefort/wall)
"aw" = (/obj/item/flashlight/lantern,/mob/living/simple_animal/hostile/skeleton,/turf/open/floor/wood,/area/ruin/space/has_grav/spacefort/wall)
"ax" = (/obj/item/flashlight/lantern,/turf/open/floor/wood{icon_state = "wood-broken"},/area/ruin/space/has_grav/spacefort/wall)
"ay" = (/obj/structure/mineral_door/sandstone,/obj/structure/barricade/wooden/crude,/turf/open/floor/wood,/area/ruin/space/has_grav/spacefort/wall)
"az" = (/obj/item/flashlight/lantern,/turf/open/floor/wood,/area/ruin/space/has_grav/spacefort/wall)
"aA" = (/turf/open/floor/grass,/area/ruin/space/has_grav/spacefort/courtyard)
"aB" = (/turf/open/floor/plating/dirt/dark,/area/ruin/space/has_grav/spacefort/courtyard)
"aC" = (/mob/living/simple_animal/hostile/skeleton,/turf/open/floor/grass,/area/ruin/space/has_grav/spacefort/courtyard)
"aD" = (/mob/living/simple_animal/hostile/skeleton,/turf/open/floor/plating/dirt/dark,/area/ruin/space/has_grav/spacefort/courtyard)
"aE" = (/obj/structure/flora/tree/dead,/turf/open/floor/grass,/area/ruin/space/has_grav/spacefort/courtyard)
"aF" = (/turf/closed/wall/mineral/sandstone,/area/ruin/space/has_grav/spacefort/keep)
"aG" = (/obj/structure/flora/tree/dead,/turf/open/floor/plating/dirt/dark,/area/ruin/space/has_grav/spacefort/courtyard)
"aH" = (/obj/structure/closet/crate/wooden,/obj/item/coin/gold,/obj/item/coin/iron,/obj/item/coin/iron,/obj/item/coin/silver,/obj/item/coin/silver,/obj/item/coin/gold,/obj/item/coin/gold,/obj/item/coin/iron,/obj/item/coin/iron,/obj/item/coin/silver,/turf/open/floor/wood,/area/ruin/space/has_grav/spacefort/keep)
"aI" = (/obj/structure/closet/crate/wooden,/obj/item/coin/gold,/obj/item/coin/silver,/obj/item/coin/silver,/obj/item/coin/gold,/obj/item/coin/gold,/obj/item/coin/iron,/obj/item/coin/iron,/obj/item/coin/silver,/obj/item/coin/silver,/obj/item/coin/silver,/turf/open/floor/wood,/area/ruin/space/has_grav/spacefort/keep)
"aJ" = (/turf/open/floor/wood,/area/ruin/space/has_grav/spacefort/keep)
"aK" = (/obj/structure/chair/pew{icon_state = "pewmiddle"; dir = 4},/turf/open/floor/wood,/area/ruin/space/has_grav/spacefort/keep)
"aL" = (/obj/structure/table/wood/fancy/red,/obj/item/storage/book/bible,/turf/open/floor/wood,/area/ruin/space/has_grav/spacefort/keep)
"aM" = (/obj/structure/fluff/divine/convertaltar,/turf/open/floor/wood,/area/ruin/space/has_grav/spacefort/keep)
"aN" = (/obj/structure/chair/pew{icon_state = "pewmiddle"; dir = 8},/turf/open/floor/wood,/area/ruin/space/has_grav/spacefort/keep)
"aO" = (/obj/item/tome,/turf/open/floor/wood,/area/ruin/space/has_grav/spacefort/keep)
"aP" = (/obj/structure/spirit_board,/turf/open/floor/wood,/area/ruin/space/has_grav/spacefort/keep)
"aQ" = (/turf/open/floor/wood{icon_state = "wood-broken"},/area/ruin/space/has_grav/spacefort/keep)
"aR" = (/mob/living/simple_animal/hostile/skeleton/templar,/turf/open/floor/wood,/area/ruin/space/has_grav/spacefort/keep)
"aS" = (/obj/structure/chair/pew{icon_state = "pewmiddle"; dir = 1},/turf/open/floor/wood,/area/ruin/space/has_grav/spacefort/keep)
"aT" = (/obj/structure/mineral_door/sandstone,/turf/open/floor/wood,/area/ruin/space/has_grav/spacefort/keep)
"aU" = (/obj/structure/grille,/obj/structure/barricade/wooden/crude,/turf/open/floor/plating/dirt,/area/ruin/space/has_grav/spacefort/wall)
"aV" = (/obj/structure/chair/bronze,/turf/open/floor/wood,/area/ruin/space/has_grav/spacefort/keep)
"aW" = (/obj/item/sharpener,/turf/open/floor/wood,/area/ruin/space/has_grav/spacefort/keep)
"aX" = (/obj/structure/table/wood/fancy/red,/turf/open/floor/wood,/area/ruin/space/has_grav/spacefort/keep)
"aY" = (/obj/item/soulstone/anybody/purified,/turf/open/floor/wood,/area/ruin/space/has_grav/spacefort/keep)
"aZ" = (/obj/structure/flora/ausbushes/pointybush,/turf/open/floor/grass,/area/ruin/space/has_grav/spacefort/courtyard)
"ba" = (/obj/structure/falsewall/sandstone,/turf/open/floor/wood,/area/ruin/space/has_grav/spacefort/keep)
"bb" = (/obj/structure/closet/cabinet,/turf/open/floor/wood,/area/ruin/space/has_grav/spacefort/keep)
"bc" = (/obj/structure/bed,/turf/open/floor/wood,/area/ruin/space/has_grav/spacefort/keep)
"bd" = (/obj/structure/chair/wood/wings{icon_state = "wooden_chair_wings"; dir = 4},/turf/open/floor/wood,/area/ruin/space/has_grav/spacefort/keep)
"be" = (/obj/structure/chair/wood/wings{icon_state = "wooden_chair_wings"; dir = 8},/turf/open/floor/wood,/area/ruin/space/has_grav/spacefort/keep)
"bf" = (/obj/structure/loom,/turf/open/floor/wood,/area/ruin/space/has_grav/spacefort/keep)
"bg" = (/obj/structure/table/wood,/obj/item/stack/sheet/cloth/ten,/turf/open/floor/wood,/area/ruin/space/has_grav/spacefort/keep)
"bh" = (/obj/structure/table/wood,/obj/item/stack/sheet/leather{amount = 20},/turf/open/floor/wood,/area/ruin/space/has_grav/spacefort/keep)
"bi" = (/obj/structure/flora/ausbushes/grassybush,/turf/open/floor/grass,/area/ruin/space/has_grav/spacefort/courtyard)
"bj" = (/obj/structure/closet/crate/wooden,/obj/item/storage/box/itemset/crusader/blue,/turf/open/floor/wood,/area/ruin/space/has_grav/spacefort/keep)
"bk" = (/obj/structure/bookcase/random/religion,/turf/open/floor/wood,/area/ruin/space/has_grav/spacefort/keep)
"bl" = (/obj/structure/bonfire/prelit,/turf/open/floor/wood,/area/ruin/space/has_grav/spacefort/keep)
"bm" = (/obj/structure/chair/wood/wings{icon_state = "wooden_chair_wings"; dir = 4},/turf/open/floor/wood{icon_state = "wood-broken"},/area/ruin/space/has_grav/spacefort/keep)
"bn" = (/obj/structure/chair/wood/wings{icon_state = "wooden_chair_wings"; dir = 4},/mob/living/simple_animal/hostile/skeleton/templar,/turf/open/floor/wood{icon_state = "wood-broken"},/area/ruin/space/has_grav/spacefort/keep)
"bo" = (/obj/structure/table/wood/fancy/red,/obj/item/flashlight/lantern,/turf/open/floor/wood,/area/ruin/space/has_grav/spacefort/keep)
"bp" = (/obj/structure/chair/wood/wings{icon_state = "wooden_chair_wings"; dir = 8},/mob/living/simple_animal/hostile/skeleton/templar,/turf/open/floor/wood,/area/ruin/space/has_grav/spacefort/keep)
"bq" = (/obj/item/book/codex_gigas,/turf/open/floor/wood,/area/ruin/space/has_grav/spacefort/keep)
"br" = (/obj/structure/bookcase,/turf/open/floor/wood,/area/ruin/space/has_grav/spacefort/keep)
"bs" = (/obj/structure/stone_tile/slab,/turf/open/floor/plating/dirt,/area/ruin/space/has_grav/spacefort/courtyard)
"bt" = (/obj/structure/stone_tile/slab/cracked,/turf/open/floor/plating/dirt,/area/ruin/space/has_grav/spacefort/courtyard)
"bu" = (/obj/machinery/hydroponics/soil,/obj/item/seeds/grape,/turf/open/floor/grass,/area/ruin/space/has_grav/spacefort/courtyard)
"bv" = (/obj/structure/headpike,/turf/open/floor/grass,/area/ruin/space/has_grav/spacefort/courtyard)
"bw" = (/obj/item/shovel,/turf/open/floor/grass,/area/ruin/space/has_grav/spacefort/courtyard)
"bx" = (/obj/machinery/hydroponics/soil,/obj/item/seeds/cotton,/turf/open/floor/grass,/area/ruin/space/has_grav/spacefort/courtyard)
"by" = (/obj/structure/flora/ausbushes/brflowers,/turf/open/floor/grass,/area/ruin/space/has_grav/spacefort/courtyard)
"bz" = (/obj/structure/bonfire/prelit,/turf/open/floor/grass,/area/ruin/space/has_grav/spacefort/courtyard)
"bA" = (/obj/structure/sink/puddle,/turf/open/floor/grass,/area/ruin/space/has_grav/spacefort/courtyard)
"bB" = (/obj/machinery/hydroponics/soil,/obj/item/seeds/wheat,/turf/open/floor/grass,/area/ruin/space/has_grav/spacefort/courtyard)
"bC" = (/obj/machinery/hydroponics/soil,/obj/item/seeds/wheat,/turf/open/floor/plating/dirt/dark,/area/ruin/space/has_grav/spacefort/courtyard)
"bD" = (/obj/structure/mineral_door/sandstone,/turf/open/floor/wood{icon_state = "wood-broken"},/area/ruin/space/has_grav/spacefort/wall)
"bE" = (/mob/living/simple_animal/hostile/skeleton/templar,/turf/open/floor/wood,/area/ruin/space/has_grav/spacefort/wall)
"bF" = (/obj/structure/bed,/turf/open/floor/wood,/area/ruin/space/has_grav/spacefort/wall)
"bG" = (/obj/structure/bed,/turf/open/floor/wood{icon_state = "wood-broken"},/area/ruin/space/has_grav/spacefort/wall)
"bH" = (/obj/structure/closet/crate/wooden,/obj/item/instrument/violin,/turf/open/floor/wood,/area/ruin/space/has_grav/spacefort/wall)
"bI" = (/obj/structure/bonfire/prelit,/turf/open/floor/wood,/area/ruin/space/has_grav/spacefort/wall)
"bJ" = (/obj/structure/closet/crate/wooden,/obj/item/instrument/trumpet,/turf/open/floor/wood,/area/ruin/space/has_grav/spacefort/wall)
"bK" = (/mob/living/simple_animal/hostile/skeleton,/mob/living/simple_animal/hostile/skeleton,/turf/open/floor/wood{icon_state = "wood-broken"},/area/ruin/space/has_grav/spacefort/wall)
"bL" = (/obj/structure/fermenting_barrel,/turf/open/floor/wood,/area/ruin/space/has_grav/spacefort/wall)
"bM" = (/obj/structure/closet/crate/wooden,/obj/item/instrument/guitar,/turf/open/floor/wood,/area/ruin/space/has_grav/spacefort/wall)

(1,1,1) = {"
aaaaaaaaaaaaaaaaaaaaaaaaaaaaaaaaaaaaaaaaaaaaaaaaaaaaaaaaaaaaaaaaaaaaaaaaaaaaaaaaaaaaaaaaaaaaaaaaaa
aaaaaaaaaaaaaaaaaaaaaaaaaaaaaaaaaaaaaaaaaaaaaaaaaaaaaaaaaaaaaaaaaaaaaaaaaaaaaaaaaaaaaaaaaaaaaaaaaa
aaabababababababababaaaaaaaaaaaaaaaaaaaaaaaaaaaaaaaaaaaaaaaaaaaaaaaaaaaaaaaaaaaaababababababababab
aaabacadacaeafacacabaaaaaaaaaaaaaaaaaaaaaaaaaaaaaaaaaaaaaaaaaaaaaaaaaaaaaaaaaaaaabagacagacagacagab
aaabacahaiajakalacamaaaaaaaaaaaaaaaaaaaaaaaaaaaaaaaaaaaaaaaaaaaaaaaaaaaaaaaaaaaaamagacanacagafanab
aaabacaoacacapacaqamaaaaaaaaaaaaaaaaaaaaaaaaaaaaaaaaaaaaaaaaaaaaaaaaaaaaaaaaaaaaamagacacafacacagab
aaabacafaqacacacacabaaaaaaaaaaaaaaaaaaaaaaaaaaaaaaaaaaaaaaaaaaaaaaaaaaaaaaaaaaaaabagacacacacacagab
aaabacarasasatatacabababababababababamamababababababababababamamabababababababababagacacauacacagab
aaabacacafapacafafavacacacacacawacacacacacacacacacacacacafafacacacacacaxacacacacayacafacafafacagab
aaabacacacacazacacavacacacacacacacacacacacacacaxacacazacacacacacacapacacacacafacayacacacazacacagab
aaababamamababavavababababababababamamamamabababavavabababamamamamababababababababayayababamamabab
aaaaaaaaaaaaabacacabaAaAaAaAaAaAaAaAaAaAaAaAaBaBaAaAaAaAaAaAaAaAaAaAaAaAaAaAaAaAabacacabaaaaaaaaaa
aaaaaaaaaaaaabacacabaBaBaAaAaAaAaAaAaAaAaAaAaBaBaAaAaAaAaAaAaAaAaBaBaBaAaAaAaAaAabacafabaaaaaaaaaa
aaaaaaaaaaaaabacacabaAaAaBaBaAaAaAaAaAaAaAaCaAaAaAaAaAaAaAaAaAaAaBaDaBaAaAaAaAaAabacacabaaaaaaaaaa
aaaaaaaaaaaaabacacabaAaAaAaAaBaBaBaBaAaAaAaAaAaAaBaBaBaBaAaAaAaAaAaAaAaAaAaEaAaAabacacabaaaaaaaaaa
aaaaaaaaaaaaabazacabaAaAaAaAaBaBaBaBaAaAaAaAaAaAaBaBaBaBaAaAaAaAaAaAaAaAaAaAaAaAabafafabaaaaaaaaaa
aaaaaaaaaaaaabacacabaAaAaAaAaBaBaBaBaAaAaAaAaAaAaBaBaBaBaAaAaAaAaAaAaAaAaBaDaBaAabafaxabaaaaaaaaaa
aaaaaaaaaaaaabacacabaAaBaAaAaAaFaFaFaFaFaFaFaFaFaFaFaFaFaFaFaFaFaFaFaFaAaBaBaBaAabacacabaaaaaaaaaa
aaaaaaaaaaaaabapacabaAaGaAaAaAaFaHaIaFaJaJaKaJaLaMaMaLaJaNaJaJaFaOaPaFaAaBaBaBaAabacacabaaaaaaaaaa
aaaaaaaaaaaaabacacamaAaAaAaCaAaFaJaJaFaQaJaKaJaJaRaJaJaJaNaJaJaFaJaRaFaAaAaAaAaAamafacabaaaaaaaaaa
aaaaaaaaaaaaamacacamaAaAaAaAaAaFaJaJaFaJaJaKaJaSaSaSaSaQaNaJaJaFaJaJaFaAaAaAaAaAamacacamaaaaaaaaaa
aaaaaaaaaaaaamacacamaAaAaAaAaAaFaJaJaTaQaQaJaJaJaJaJaJaJaJaJaJaTaJaJaFaAaAaAaAaAamacacaUaaaaaaaaaa
aaaaaaaaaaaaabacacamaAaAaAaAaBaFaFaFaFaFaFaJaJaVaVaVaVaJaJaFaFaFaFaFaFaAaBaBaBaAamacacabaaaaaaaaaa
aaaaaaaaaaaaabacacabaAaAaAaAaAaFaJaJaJaWaFaJaJaXaXaXaXaJaJaFaYaQaJaJaFaEaBaBaBaBabacacabaaaaaaaaaa
aaaaaaaaaaaaabacacabaAaCaZaAaAaFbaaFaFaFaFaQaJaJaJaJaJaJaJaFaFaFaFbaaFaAaBaBaBaAabacacabaaaaaaaaaa
aaaaaaaaaaaaabacazabaAaAaAaAaAaFbbaJaJbcaFaQbdaXaJaQaXbeaJaFbfbgbhaQaFaAaBaBaBaAabaxacabaaaaaaaaaa
aaaaaaaaaaaaabacapavaAaAaAaAaAaFaJaRaJaJaFaJbdaXaJaJaXbeaJaFaJaJaJaJaFaAaAaAaAaAavafacabaaaaaaaaaa
aaaaaaaaaaaaabacacavaAaZaBbiaAaFbjaJaJaJaTaJbdaXaJaJaXbeaJaTaJaQaQaJaFaAaAaCaAaAavacafabaaaaaaaaaa
aaaaaaaaaaaaabacaxabaAaAaAaAaAaFaFaFaFaFaFaJbdaXaJaJaXbeaJaFaFaFaFaFaFaBaAaAaAaAabazapabaaaaaaaaaa
aaaaaaaaaaaaabacafabaAaAaAaAaAaFaJaJaJaJaFaJbdaXaJaJaXbeaJaFbkbkbkbkaFaAaAaAaAaAabacacabaaaaaaaaaa
aaaaaaaaaaaaabacacabaAbiaAaZaAaFaJblaJaJaFaJbmaXaJaQaXbeaJaFaJaJaJaJaFaAaAaAaEaAabacacabaaaaaaaaaa
aaaaaaaaaaaaabacacamaAbiaAaAaAaFaJaJaJaJaFaJbnboaJaJbobpaJaFbqblaJbraFaAaAaAaAaAamacacabaaaaaaaaaa
aaaaaaaaaaaaaUacafamaAaAaAbiaAaFaJaRaJaJaFaJaJaJaJaJaJaJaJaFaJaJaRaJaFaAaAaBaBaAamacacamaaaaaaaaaa
aaaaaaaaaaaaaUacafamaAaAaBaAaAaFaJaJaJaJaTaJaJaJaQaJaJaJaJaTaJbrbrbraFaAaAaBaBaAamafafamaaaaaaaaaa
aaaaaaaaaaaaabacafamaAbiaBaCaAaFaFaFaFaFaFaFaFaFaTaTaFaFaFaFaFaFaFaFaFaAaAaCaAaAamacacabaaaaaaaaaa
aaaaaaaaaaaaabacacabaAaAaAaAaAaAaAaAaAaAaAaAaAaAbsbtaAaAaAaAaAaAaAaAaAaAaAaAaAaAabacacabaaaaaaaaaa
aaaaaaaaaaaaabacacabbububuaAaAaAaBaBaBaAaAaAbvaAbtbsaAaAbvaAaAaAbwaAbxbxbxbxbxbxabacazabaaaaaaaaaa
aaaaaaaaaaaaabazacabaAaAaAaAbyaAaBaBaBaAaAbyaAaAbsbtaAaAaAaAaBaAaAaCaAaAaBaAaAaAabapacabaaaaaaaaaa
aaaaaaaaaaaaabacacabbububuaBaBaAaAaAaAaAaAaAbzaAbsbtaAaAbzaAaBaAbAaAbBbBbCbBbBbBabafacabaaaaaaaaaa
aaaaaaaaaaaaabafacabaAaAaAaBaBaAbybyaAaEaAbybvaAbtbsaBaAbvaAaBaAaAaAaAaAaAaAaAaAabacacabaaaaaaaaaa
aaaaaaaaaaaaabacacabbububuaBaDaAaAbyaAaAaAbyaAaAbtbsaBaAaAaAaAaAaAaAbBbBbBbBbBbBabacacabaaaaaaaaaa
aaababamamababavavabababababababababababababababavavabababababababababababababababavavababamamabab
aaabacacacacacacacavacacafafazacacacacacacbDacazafacazbEavacacacacazapacacacafafavacacbFazbFacbFab
aaabacacacacapafafavacacafacacacacapacacacavacacacacacacavacacacacacafacacacacacavacafbGacbFacbFab
aaabafacacacacacacabababababababababababababababayayabababababababababababababababbHafaoacacafbGab
aaabacacacbIacacazabaaaaaaaaaaaaaaaaaaaaaaabacazacacazafabaaaaaaaaaaaaaaaaaaaaaaabbJacacbIafaobGab
aaabacacacafacafacamaaaaaaaaaaaaaaaaaaaaaaabacafafacacapabaaaaaaaaaaaaaaaaaaaaaaamacacapacacacbFab
aaabacacacacacaoacamaaaaaaaaaaaaaaaaaaaaaaabacacacacafacabaaaaaaaaaaaaaaaaaaaaaaamacacbGacbFacbFab
aaabacbKacacbLbLbLabaaaaaaaaaaaaaaaaaaaaaaabababavavabababaaaaaaaaaaaaaaaaaaaaaaabbMacbFacbFacbFab
aaabababababababababaaaaaaaaaaaaaaaaaaaaaaaaaaaaaaaaaaaaaaaaaaaaaaaaaaaaaaaaaaaaababababababababab
"}
